abandoned	negative
aberration	negative
abhorred	negative
abhorrent	negative
abhors	negative
abidance	positive
abject	negative
able	positive
abnormal	negative
abominable	negative
above-average	positive
abrasive	negative
abrupt	negative
absent-minded	negative
absolute	neutral
absolutely	neutral
absurd	negative
abundant	positive
abuse	negative
abuses	negative
abusive	negative
abysmal	negative
acceptable	positive
accessible	positive
accidental	negative
acclaimed	positive
accommodative	positive
accountable	negative
accurate	positive
accurately	positive
accursed	negative
accusation	negative
accusations	negative
acerbic	negative
achievable	positive
acrid	negative
acrimonious	negative
active	positive
activist	neutral
adamant	negative
adaptable	positive
adaptive	positive
adept	positive
adequate	positive
adherent	positive
admirable	positive
admiring	positive
admiringly	positive
admission	positive
adolescents	neutral
adorable	positive
adored	positive
adoring	positive
adroit	positive
adroitly	positive
adulatory	positive
advanced	positive
advantage	positive
advantageous	positive
advantages	positive
adventure	positive
adventurous	positive
adversarial	negative
adverse	negative
advice	positive
affable	positive
affected	neutral
affection	positive
affectionate	positive
affirmation	positive
afflictive	negative
affluent	positive
affordable	positive
afloat	positive
afraid	negative
aggravating	negative
aggression	negative
aggrieved	negative
aghast	negative
agile	positive
agitated	negative
agonizing	negative
agreeable	positive
agreement	positive
aimless	negative
airs	negative
alarm	negative
alarmed	negative
alarming	negative
alert	neutral
alienated	negative
all-time	neutral
allegations	negative
allergic	negative
alliances	neutral
allowable	positive
allusion	neutral
almighty	positive
aloof	negative
altruistic	positive
altruistically	positive
amazed	positive
amazing	positive
ambiguous	negative
ambitious	positive
ambivalent	negative
amenable	positive
amiable	positive
amicable	positive
amity	positive
ample	positive
amusement	positive
amusing	positive
analytical	neutral
anarchistic	negative
anemic	negative
angelic	positive
anger	negative
angry	negative
animated	positive
annoyed	negative
annoying	negative
anomalous	negative
antagonistic	negative
anti-American	negative
anti-Israeli	negative
anti-Semites	negative
anti-US	negative
anti-occupation	negative
anti-proliferation	negative
anti-social	negative
anti-white	negative
antiquated	negative
antithetical	negative
apathetic	negative
apocalyptic	negative
apologist	negative
apologists	negative
apostle	positive
apotheosis	positive
appall	negative
appalled	negative
appalling	negative
appeal	positive
appealing	positive
appearance	neutral
appreciable	positive
appreciation	positive
apprehensions	negative
apprehensive	negative
appropriate	positive
apt	positive
arbitrary	negative
arcane	negative
archaic	negative
ardent	positive
arduous	negative
aristocratic	positive
argument	negative
arguments	negative
arresting	positive
arrogant	negative
articulate	positive
artificial	negative
ascendant	positive
ascertainable	positive
ashamed	negative
asinine	negative
aspirations	positive
assault	negative
assertions	positive
assertive	positive
assessment	neutral
assessments	neutral
assiduous	positive
assumption	neutral
assurance	positive
assurances	positive
astonished	positive
astonishing	positive
astounded	positive
astounding	positive
astray	negative
astronomic	neutral
astronomical	neutral
astute	positive
asylum	positive
atrocious	negative
attainable	positive
attentive	positive
attitude	neutral
attitudes	neutral
attraction	positive
attractive	positive
attune	positive
audacious	negative
auspicious	positive
austere	negative
authentic	positive
authoritarian	negative
authoritative	positive
autocratic	negative
award	positive
aware	neutral
autocratic	negative
autonomous	positive
avalanche	negative
avaricious	negative
avariciously	negative
avid	positive
awed	positive
awesome	positive
awestruck	positive
awful	negative
awkward	negative
baby	neutral
backward	negative
bad	negative
badly	negative
baffled	negative
balanced	positive
banal	negative
banish	negative
bankrupt	negative
barbarian	negative
barbaric	negative
barbarity	negative
barbarous	negative
bargain	positive
barren	negative
baseless	negative
bashful	negative
basic	positive
batons	neutral
battered	negative
battering	negative
battle-lines	negative
battleground	negative
batty	negative
bearish	negative
beast	negative
beastly	negative
beauteous	positive
beautiful	positive
befitting	positive
beggarly	negative
begging	negative
belated	negative
belief	neutral
beliefs	neutral
believable	positive
belittled	negative
bellicose	negative
belligerent	negative
beloved	positive
bemoaning	negative
bemused	negative
beneficial	positive
beneficent	positive
beneficiary	positive
benefit	positive
benefits	positive
benevolent	positive
benign	positive
bent	negative
berserk	negative
beset	negative
best-known	positive
best-performing	positive
best-selling	positive
bestial	negative
better	positive
better-known	positive
better-than-expected	positive
bewildered	negative
bewildering	negative
bias	negative
biased	negative
biases	negative
bid-rigging	negative
big	neutral
bitchy	negative
biting	negative
bitter	negative
bizarre	negative
black	negative
blame	negative
blameless	positive
blameworthy	negative
bland	negative
blasphemous	negative
blatant	negative
blatantly	negative
bleak	negative
blessing	positive
blinding	negative
blindingly	negative
blindness	negative
blissful	positive
blistering	negative
blithe	positive
bloated	negative
blockhead	negative
blood	neutral
bloodthirsty	negative
bloody	negative
blow	negative
blunder	negative
blunt	negative
boastful	negative
bogus	negative
boisterous	negative
bold	positive
bombardment	negative
bombastic	negative
bonkers	negative
bonny	positive
booming	positive
boost	positive
boring	negative
bothersome	negative
boundless	positive
bountiful	positive
boycott	negative
brains	positive
brainy	positive
brash	negative
brave	positive
bravery	positive
breach	negative
break-point	negative
breakthrough	positive
breakthroughs	positive
breathlessness	positive
breathtaking	positive
bright	positive
brilliant	positive
brimstone	negative
brisk	positive
brittle	negative
broad	positive
broad-based	neutral
broke	negative
broken-hearted	negative
brotherly	positive
brusque	negative
brutal	negative
brutalising	negative
brutalizing	negative
brutish	negative
bulky	negative
bull	positive
bullies	negative
bullish	positive
bully	negative
bumpy	negative
buoyant	positive
burden	negative
burdensome	negative
busy	negative
byzantine	negative
calamitous	negative
callous	negative
calm	positive
calumnious	negative
cancerous	negative
candid	positive
capable	positive
capably	positive
capricious	negative
captivating	positive
captive	negative
carefree	positive
careful	positive
careless	negative
cartoon	negative
cash-strapped	negative
cataclysmal	negative
cataclysmic	negative
catalyst	positive
catastrophic	negative
catchy	positive
caustic	negative
cautionary	negative
cautious	negative
ceaseless	neutral
celebrated	positive
censure	negative
central	neutral
certified	neutral
challenging	negative
champion	positive
chant	neutral
chaotic	negative
charismatic	positive
charitable	positive
charm	positive
charming	positive
charmingly	positive
chaste	positive
cheap	negative
cheery	positive
cheerful	positive
cheerless	negative
cherished	positive
chic	positive
childish	negative
chilly	negative
chivalrous	positive
choppy	negative
chronic	negative
civilize	positive
civil	positive
clamorous	negative
clandestine	neutral
clarity	positive
clash	negative
clean	positive
clear-cut	positive
clearer	positive
clever	positive
close	negative
closeness	positive
clout	positive
clumsy	negative
co-operation	positive
coarse	negative
cocky	negative
coercive	negative
cogent	positive
cohesive	positive
cognizance	neutral
coherence	positive
coherent	positive
cohesive	positive
cold	negative
collapse	negative
colorful	positive
colossal	positive
combative	negative
comeback	positive
comedy	negative
comely	positive
comfortable	positive
comical	negative
commendable	positive
commensurate	positive
commonsensible	positive
commonsensical	positive
comment	neutral
commentator	neutral
commodious	positive
commitment	positive
commonplace	negative
commotion	negative
compact	positive
compassionate	positive
compatible	positive
compelling	positive
competent	positive
competitive	positive
complacent	negative
complaining	negative
complaints	negative
complete	neutral
complex	negative
compliant	positive
complicated	negative
complicit	negative
comprehensive	positive
compromise	positive
compromises	positive
compulsive	negative
compulsory	negative
comrades	positive
conceited	negative
conceivable	positive
concern	negative
concerning	neutral
concerns	negative
concerted	neutral
concession	negative
concessions	negative
conciliatory	positive
conclusive	positive
concrete	positive
condescending	negative
condemnable	negative
condolences	negative
conducive	positive
confessions	negative
confidence	positive
confident	positive
conflict	negative
confrontation	negative
confrontational	negative
confusing	negative
confusion	negative
congenial	positive
congested	negative
congratulations	positive
conscience	neutral
conscientious	positive
consciousness	neutral
considerable	neutral
considerate	positive
consideration	neutral
consistent	positive
conspicuous	negative
conspiracies	negative
conspiracy	negative
conspirator	negative
constitutions	neutral
constructive	positive
constructive	positive
consummate	positive
contagious	negative
contemptible	negative
contemptuous	negative
content	positive
contentious	negative
continuous	neutral
contortions	negative
contradictory	negative
contrary	negative
contribution	positive
controversial	negative
controversy	negative
convenient	positive
conviction	positive
convincing	positive
convoluted	negative
cooperation	positive
cooperative	positive
coping	negative
cordial	positive
cornerstone	positive
correct	positive
corrective	neutral
corrosive	negative
corrupt	negative
cost-effective	positive
cost-saving	positive
costly	negative
counterproductive	negative
coupists	negative
courage	positive
courageous	positive
courteous	positive
courtly	positive
covert	neutral
coveting	both
covetous	negative
cozy	positive
crackdown	negative
crafty	negative
cramped	negative
cranky	negative
crass	negative
creative	positive
credence	positive
credible	positive
credulous	negative
crippling	negative
crisis	negative
crisp	positive
criticism	negative
criticisms	negative
critics	negative
crooked	negative
cross	negative
crowded	negative
crude	negative
cruel	negative
crusade	positive
crushing	negative
culpable	negative
cumbersome	negative
cure-all	positive
cursed	negative
cursory	negative
curt	negative
cute	positive
cutthroat	negative
cynical	negative
damaging	negative
damn	negative
danger	negative
dangerous	negative
dangerousness	negative
dark	negative
dashing	positive
dauntless	positive
dazed	negative
dazzled	positive
dead	negative
deadbeat	negative
deadly	negative
deadweight	negative
deaf	negative
dear	positive
debilitating	negative
decadent	negative
deceiving	negative
decent	positive
deception	negative
deceptive	negative
decisive	positive
decisiveness	positive
declining	negative
decreasing	negative
decrepit	negative
dedicated	positive
deep	neutral
deepening	negative
defective	negative
defender	positive
defensive	negative
defiance	negative
defiant	negative
deficient	negative
definite	positive
definitive	positive
deflationary	positive
deformed	negative
defrauding	negative
deft	positive
defunct	negative
degenerate	negative
degrading	negative
dejected	negative
dejectedly	negative
delectable	positive
delicate	positive
delicious	positive
delighted	positive
delightful	positive
delinquent	negative
delirious	negative
deluded	negative
delusion	negative
delusional	negative
delusions	negative
demand	both
demands	both
demeaning	negative
democratic	positive
demonic	negative
dependable	positive
dependent	neutral
deplorable	negative
deploring	negative
depraved	negative
depressed	negative
depressing	negative
depression	negative
deprived	negative
derogatory	negative
deserved	positive
deserving	positive
desiccated	negative
desirable	positive
desire	positive
desolate	negative
despairing	negative
desperate	negative
despicable	negative
despised	negative
despondent	negative
despotic	negative
despotism	negative
destabilisation	negative
destined	positive
destinies	positive
destiny	neutral
destitute	negative
destroyer	negative
destructive	negative
desultory	negative
deteriorate	negative
deteriorating	negative
determination	positive
detrimental	negative
deviate	negative
devilish	negative
devoid	negative
devoted	positive
devout	positive
dexterous	positive
dextrous	positive
diabolic	negative
diabolical	negative
dictatorial	negative
difference	neutral
difficult	negative
difficulties	negative
difficulty	negative
diffidence	negative
dignified	positive
dilapidated	negative
dilemma	negative
diligent	positive
dim	negative
diminishing	negative
dinky	negative
diplomacy	neutral
diplomatic	positive
dire	negative
direct	neutral
dirty	negative
disabled	negative
disadvantaged	negative
disadvantageous	negative
disaffected	negative
disagreement	negative
disappointed	negative
disappointment	negative
disapproval	negative
disarray	negative
disastrous	negative
disconcerted	negative
disconsolate	negative
discontent	negative
discontented	negative
discontinuity	negative
discordant	negative
discourteous	negative
discourteously	negative
discreet	positive
discrepant	negative
discriminating	positive
discrimination	negative
discriminatory	negative
diseased	negative
disgraced	negative
disgruntled	negative
disgusted	negative
disgustful	negative
dishonest	negative
dishonorable	negative
disillusioned	negative
disingenuous	negative
disinterested	negative
disinterested	negative
dislocated	negative
disloyal	negative
dismal	negative
dismayed	negative
dismissive	negative
disobedient	negative
disordered	negative
disorderly	negative
disorganized	negative
disoriented	negative
disparaging	negative
dispensable	negative
dispirited	negative
displaced	negative
displeasing	negative
displeasure	negative
disproportionate	negative
disputed	negative
disregard	negative
disregardful	negative
disreputable	negative
disrespectable	negative
disrespecting	negative
disruption	negative
disruptive	negative
dissatisfaction	negative
dissatisfactory	negative
dissatisfied	negative
dissent	negative
disservice	negative
dissident	negative
dissidents	negative
dissocial	negative
dissolute	negative
dissonant	negative
dissuasive	negative
distasteful	negative
distinct	positive
distinctive	positive
distinctive	positive
distinctly	neutral
distinguished	positive
distortion	negative
distracting	negative
distraction	negative
distraught	negative
distressed	negative
distressing	negative
distrustful	negative
disturbed	negative
disturbed-let	negative
divergent	negative
diversified	positive
divided	negative
divine	positive
divisive	negative
divorced	negative
dizzy	negative
dizzing	negative
doddering	negative
dodge	positive
dodgey	negative
dogged	negative
dogmatic	negative
dominance	negative
dominant	neutral
domination	negative
domineering	negative
doomsday	negative
doubtful	negative
doubts	negative
downbeat	negative
downcast	negative
downhearted	negative
drab	negative
draconian	negative
draconic	negative
dragons	negative
drain	negative
drama	negative
dramatic	neutral
drastic	negative
drastically	negative
dream	positive
dreams	positive
dreamy	positive
dreary	negative
driven	positive
drones	negative
drought	negative
drunk	negative
drunken	negative
dubious	negative
dubitable	negative
dull	negative
dumb	negative
dumbfounded	negative
dungeons	negative
durable	positive
dusty	negative
dwindling	negative
dynamic	positive
eager	positive
earnest	positive
earsplitting	negative
easy	positive
easygoing	positive
ebullient	positive
eccentric	negative
eclectic	positive
economical	positive
ecstatic	positive
edgy	negative
educable	positive
educated	positive
educational	positive
effective	positive
effectual	positive
efficacious	positive
efficient	positive
effortless	positive
effusive	positive
egalitarian	positive
ego	negative
egocentric	negative
egotistical	negative
egregious	negative
elaborate	neutral
elated	positive
election-rigger	negative
electrification	positive
elegant	positive
elevated	positive
eligible	positive
eloquent	positive
embattled	negative
embroiled	negative
eminent	positive
emotion	neutral
emotional	negative
emotions	neutral
emphasise	neutral
emptiness	negative
empty	negative
encouragement	positive
encouraging	positive
endearing	positive
endless	negative
endorsement	positive
endurable	positive
enduring	positive
enemies	negative
energetic	positive
engaging	positive
enhanced	positive
enjoyable	positive
enraged	negative
enrapt	positive
enterprising	positive
entertaining	positive
enthusiastic	positive
entrancing	positive
entrenchment	neutral
enviable	positive
envious	negative
envisions	positive
epic	positive
epidemic	negative
equality	positive
equitable	positive
equivocal	negative
errant	negative
erratic	negative
erroneous	negative
error	negative
erudite	positive
esoteric	negative
essential	positive
estranged	negative
established	positive
eternal	negative
eternity	positive
ethical	positive
euphoric	positive
evaluation	neutral
evasive	negative
eventful	positive
everlasting	positive
evil	negative
evils	negative
evocative	positive
exact	neutral
exacting	negative
exaggeration	negative
exalt	positive
exalted	positive
exalting	positive
exasperating	negative
exceeding	positive
excessive	negative
excessively	negative
excited	positive
exciting	positive
exclusive	positive
exclusively	neutral
excusable	positive
excuse	negative
excuses	negative
exemplary	positive
exhaustive	positive
exorbitant	negative
expansive	positive
expectation	neutral
expedient	negative
expediencies	negative
expensive	negative
experienced	positive
expert	positive
explicit	positive
exploitation	negative
exposed	negative
explosive	negative
expression	neutral
expressions	neutral
expressive	positive
expropriate	negative
expropriation	negative
exquisite	positive
extensive	neutral
extraneous	negative
extravagant	negative
extreme	negative
extremism	negative
extremist	negative
extremists	negative
exuberant	positive
eyebrows	neutral
fabulous	positive
facetious	negative
failure	negative
failures	negative
faint	negative
fainthearted	negative
fair	positive
fairness	positive
faith	positive
faithful	positive
faithless	negative
fake	negative
fallacies	negative
fallacious	negative
false	negative
famed	positive
familiar	neutral
famed	positive
famished	negative
famous	positive
famously	positive
fanatical	negative
fanciful	negative
fancy	positive
fanfare	positive
fantasy	positive
far-fetched	negative
far-reaching	neutral
farfetched	negative
farcical-yet-provocative	negative
farsighted	positive
fascism	negative
fashionable	positive
fast	neutral
fast-growing	positive
fast-paced	positive
fastest-growing	positive
fastidious	negative
fastuous	negative
fat	negative
fatal	negative
fatalistic	negative
fateful	negative
fathomless	negative
fatty	negative
fatuous	negative
faulty	negative
favor	positive
favorable	positive
favored	positive
favorite	positive
fearful	negative
fearless	positive
fears	negative
fearsome	negative
feasible	positive
feckless	negative
feeble	negative
feeblely	negative
feebleminded	negative
feeling	neutral
feelings	neutral
feisty	positive
felicitous	positive
fell	negative
felonious	negative
ferocious	negative
fertile	positive
fervent	positive
fervid	positive
feverish	negative
festive	positive
fetid	negative
fiat	negative
fickle	negative
fiction	negative
fictional	negative
fictitious	negative
fidgety	negative
fiendish	negative
fierce	negative
fiery	positive
fight	negative
figurehead	negative
filthy	negative
fine	positive
finely	positive
firm	neutral
first-class	positive
first-rate	positive
fissures	negative
fit	positive
fitting	positive
fixer	neutral
flagging	negative
flak	negative
flakey	negative
flaky	negative
flame	positive
flash	negative
flattering	positive
flaw	negative
flawed	negative
flawless	positive
fleeting	negative
flexible	positive
flighty	negative
flimsy	negative
flourish	positive
flourishing	positive
fluent	positive
fond	positive
foolhardy	negative
foolproof	positive
forbid	negative
forbidden	negative
forbidding	negative
forceful	negative
foreboding	negative
foremost	positive
forged	negative
forgiven	positive
forlorn	negative
formidable	negative
forthright	neutral
fortress	neutral
fortuitous	positive
fortuitously	positive
fortunate	positive
fortune	positive
foul	negative
fractious	negative
fragile	negative
fragmented	negative
fragrant	positive
frail	negative
frank	positive
frantic	negative
fraud	negative
fraudulent	negative
fraught	negative
freakish	negative
frazzled	negative
free	positive
freedom	positive
freedoms	positive
frenetic	negative
frenzied	negative
frequent	neutral
fresh	positive
fretful	negative
friction	negative
frictions	negative
friend	positive
friendliness	positive
friendly	positive
friends	positive
friendship	positive
frightening	negative
frighteningly	negative
frightful	negative
frigid	negative
frivolous	negative
frown	negative
frozen	negative
fruitful	positive
fruitless	negative
frustrated	negative
frustrating	negative
fudge	negative
fugitive	negative
fulfillment	positive
full	neutral
full-blown	negative
full-fledged	positive
full-scale	neutral
fun	positive
functional	positive
fundamental	neutral
fundamentalism	negative
funded	neutral
funny	positive
furious	negative
fuss	negative
fusty	negative
futile	negative
fuzzy	negative
gainful	positive
gallant	positive
galling	negative
game	negative
garbage	negative
garish	negative
gasp	negative
gauche	negative
gaudy	negative
gawky	negative
gem	positive
gems	positive
generous	positive
generously	positive
genial	positive
genocide	negative
gentle	positive
genuine	positive
germane	positive
gestures	neutral
get-rich	negative
ghastly	negative
giant	neutral
giants	neutral
giddy	positive
gifted	positive
gigantic	neutral
glad	positive
glamorous	positive
glaring	negative
glib	negative
glimmer	positive
glisten	positive
glitter	positive
gloomy	negative
glorious	positive
glossy	positive
glum	negative
go-ahead	positive
goading	negative
golden	positive
goodwill	positive
gorgeous	positive
gossip	negative
graceful	positive
graceless	negative
gracious	positive
grail	positive
grand	positive
grandiose	negative
grateful	positive
grating	negative
gratitude	positive
gratuitous	negative
grave	negative
great	positive
greatest	positive
greedy	negative
grievances	negative
grieving	negative
grim	negative
grind	negative
grisly	negative
grit	positive
gritty	negative
gross	negative
grotesque	negative
grouchy	negative
groundbreaking	positive
groundless	negative
growing	neutral
grudges	negative
gruff	negative
guidance	positive
guiltless	positive
guilty	negative
gullible	negative
gutsy	positive
haggard	negative
halcyon	positive
hale	positive
halfhearted	negative
halfheartedly	negative
halfway	neutral
hallowed	positive
halt	neutral
handicapped	negative
handsome	positive
handy	positive
hapless	negative
haphazard	negative
happy	positive
harassment	negative
harboring	negative
harbors	negative
hard	negative
hard-hit	negative
hard-line	negative
hard-working	positive
hardball	negative
hardened	negative
hardheaded	negative
hardhearted	negative
hardier	positive
hardliners	negative
hardships	negative
hardy	positive
harm	negative
harmful	negative
harmless	positive
harmonious	positive
harmony	positive
harms	negative
harried	negative
harsh	negative
haste	negative
hasty	negative
hasty	negative
hateful	negative
haughty	negative
haunting	negative
hawkish	negative
hazardous	negative
hazy	negative
headaches	negative
heady	positive
healthful	positive
healthy	positive
heart	positive
heartbreaking	negative
heartening	positive
heartfelt	positive
heartily	positive
heartless	negative
heartrending	negative
heartwarming	positive
heathen	negative
heavy-duty	neutral
heavy-handed	negative
heavyhearted	negative
heck	negative
hectic	negative
hedonistic	negative
heedless	negative
hefty	neutral
hegemonism	negative
hegemonistic	negative
hegemony	negative
heinous	negative
hell-bent	negative
help	positive
helpful	positive
helpless	negative
heretical	negative
heroic	positive
hesitant	negative
hideous	negative
high	neutral
high-powered	neutral
high-quality	positive
hilarious	positive
historic	positive
hollow	negative
holy	positive
honest	positive
honesty	positive
honor	positive
hope	positive
hopeless	negative
hopes	positive
horrendous	negative
horrible	negative
horrid	negative
horrific	negative
horrify	negative
hospitable	positive
hostile	negative
hostilities	negative
hostility	negative
hot	positive
hotheaded	negative
hotbeds	negative
hothouse	negative
hug	positive
huge	neutral
humane	positive
humanists	positive
humiliating	negative
humour	positive
hungry	negative
hurt	negative
hurtful	negative
hypocritical	negative
hysteric	negative
icy	negative
idea	neutral
ideal	positive
idle	negative
idol	positive
idolized	positive
ignoble	negative
ignominious	negative
ignorance	negative
ignorant	negative
ill	negative
ill-advised	negative
ill-conceived	negative
ill-fated	negative
ill-favored	negative
ill-mannered	negative
ill-natured	negative
ill-sorted	negative
ill-tempered	negative
ill-treated	negative
ill-treatment	negative
ill-used	negative
illegal	negative
illegitimate	negative
illicit	negative
illiquid	negative
illiterate	negative
illogical	negative
illuminati	positive
illusion	negative
illusions	negative
illusory	negative
illustrious	positive
imaginary	negative
imagination	neutral
imaginative	positive
imbalance	negative
immaculate	positive
immaterial	negative
immature	negative
immediate	neutral
immense	neutral
imminent	negative
immoderate	negative
immodest	negative
immoral	negative
immovable	negative
immune	neutral
impaired	negative
impartial	positive
impassioned	positive
impassive	negative
impatient	negative
impeccable	positive
impending	negative
impenitent	negative
imperative	neutral
imperfect	negative
imperial	positive
imperious	negative
impermissible	negative
impersonal	negative
impertinent	negative
imperturbable	positive
impervious	positive
impetuous	negative
impious	negative
implacable	negative
implausible	negative
implication	negative
implicit	neutral
imploring	both
impolite	negative
impolitic	negative
important	positive
importunate	negative
imposers	negative
imposing	negative
imposition	negative
impossible	negative
impotent	negative
impoverished	negative
impractical	negative
imprecise	negative
imprecision	negative
impregnable	positive
impression	positive
impressions	positive
impressive	positive
improbable	negative
improper	negative
improving	positive
improved	positive
imprudent	negative
impudent	negative
impulsive	negative
impunity	negative
impure	negative
inability	negative
inaccessible	negative
inaccurate	negative
inactive	negative
inadequate	negative
inadverent	negative
inadvisable	negative
inalienable	positive
inane	negative
inappropriate	negative
inapt	negative
inarguable	neutral
inarticulate	negative
inattentive	negative
incapable	negative
incautious	negative
incessant	negative
incisive	positive
incitement	negative
inclement	negative
inclination	positive
inclined	positive
inclusive	positive
incognizant	negative
incoherent	negative
incoherently	negative
incommensurate	negative
incomparable	negative
incompatible	negative
incompetent	negative
incomplete	negative
incompliant	negative
incomprehensible	negative
inconceivable	negative
inconclusive	negative
incongruous	negative
inconsequent	negative
inconsequential	negative
inconsiderate	negative
inconsistencies	negative
inconsistent	negative
inconsolable	negative
inconstant	negative
incontestable	positive
incontrovertible	positive
inconvenience	negative
incorrigible	negative
incorruptible	positive
increasing	neutral
incredulous	negative
indebted	positive
indecent	negative
indecisive	negative
indefatigable	positive
indefensible	negative
indefinite	negative
indelible	positive
indelibly	positive
indelicate	negative
independence	positive
independent	positive
indescribable	positive
indestructible	positive
indeterminable	negative
indeterminate	negative
indication	neutral
indicative	neutral
indifferent	negative
indigent	negative
indignant	negative
indignity	negative
indirect	neutral
indiscernible	negative
indiscreet	negative
indiscriminate	negative
indiscriminating	negative
indispensable	positive
indisposed	negative
indisputable	positive
indistinct	negative
indistinctive	negative
indoctrination	negative
indolent	negative
indomitable	positive
indomitably	positive
indulgent	positive
industrious	positive
ineffective	negative
ineffectual	negative
inefficacious	negative
inefficient	negative
ineligible	negative
inelegant	negative
ineloquent	negative
inept	negative
inequalities	negative
inequality	negative
inequitable	negative
inequities	negative
inertia	negative
inescapable	negative
inescapably	negative
inessential	negative
inestimable	positive
inevitable	negative
inexact	negative
inexcusable	negative
inexorable	negative
inexpensive	positive
inexperienced	negative
inexpert	negative
inexpiable	negative
inexplainable	negative
inexplicable	negative
inextricable	negative
infallible	positive
infamous	negative
infectious	neutral
inference	neutral
inferior	negative
infernal	negative
infested	negative
infiltrators	negative
infirm	negative
inflammatory	negative
inflated	negative
inflationary	negative
inflexible	negative
influence	neutral
influential	positive
informational	neutral
informative	positive
infringements	negative
infuriated	negative
ingenious	positive
ingenuous	positive
inglorious	negative
ingratiating	positive
inherent	neutral
inhospitable	negative
inhuman	negative
inhumane	negative
inimical	negative
iniquitous	negative
injudicious	negative
injurious	negative
injustice	negative
injustices	negative
inklings	neutral
innocence	positive
innocent	positive
innocently	positive
innocuous	positive
innovation	positive
innovative	positive
innumerable	neutral
innumerous	neutral
innuendo	negative
inoffensive	positive
inopportune	negative
inordinate	negative
inquisitive	positive
insane	negative
insatiable	negative
insecure	negative
insecurity	negative
insensible	negative
insensitive	negative
insensitivity	negative
insidious	negative
insight	positive
insignificant	negative
insincere	negative
insinuating	negative
insinuation	negative
insistence	positive
insistent	positive
insociable	negative
insolent	negative
insolvent	negative
inspirational	positive
inspiring	positive
instable	negative
instructive	positive
instrumental	positive
insubordinate	negative
insubstantial	negative
insufferable	negative
insufficient	negative
insular	negative
insulted	negative
insulting	negative
insupportable	negative
insurmountable	negative
insurrection	negative
intact	positive
integral	positive
intelligent	positive
intelligible	positive
intense	neutral
intensive	neutral
intent	neutral
intention	neutral
intentions	neutral
intents	neutral
interest	positive
interested	positive
interests	positive
interference	negative
intermittent	negative
intimacy	positive
intimate	positive
intimidation	negative
intolerable	negative
intolerance	negative
intractable	negative
intransigence	negative
intricate	positive
intrigue	positive
intriguing	positive
intrusive	negative
intuitive	positive
invader	negative
invalid	negative
invaluable	positive
invasive	negative
inventive	positive
invidious	negative
invincible	positive
inviolable	positive
inviolate	positive
invisible	neutral
invulnerable	positive
involuntary	negative
irate	negative
ironic	negative
ironies	negative
irrational	negative
irreconcilable	negative
irredeemable	negative
irreformable	negative
irrefutable	positive
irregular	negative
irrelevant	negative
irreparable	negative
irreplacible	negative
irrepressible	negative
irreproachable	positive
irresistible	positive
irresolute	negative
irresolvable	negative
irresponsible	negative
irretrievable	negative
irreverent	negative
irreversible	negative
irritable	negative
irritated	negative
irritation	negative
isolated	negative
jaded	negative
jaundiced	negative
jaunty	positive
jealous	negative
jittery	negative
jobless	negative
jovial	positive
joyful	positive
joyless	positive
jubilant	positive
judgement	neutral
judgements	neutral
judicious	positive
judgment	neutral
judgments	neutral
jumpy	negative
junky	negative
just	positive
justice	positive
justifiable	positive
juvenile	negative
kaput	negative
keen	positive
keenness	positive
kemp	positive
key	neutral
kick	negative
kind	positive
kooky	negative
lack	negative
lackadaisical	negative
lackeys	negative
lacking	negative
laconic	negative
lame	negative
lame-duck	negative
languid	negative
lanky	negative
languorous	negative
large	neutral
large-scale	neutral
large	positive
lascivious	negative
last-ditch	negative
lavish	positive
law-abiding	positive
lawbreaker	negative
lawful	positive
lawless	negative
lawlessness	negative
lax	negative
lazy	negative
leading	positive
leaky	negative
lean	positive
learn	neutral
lecherous	negative
leech	negative
leery	negative
left-leaning	negative
legacies	neutral
legalistic	neutral
legendary	positive
legitimate	positive
lenient	positive
less-developed	negative
less-expensive	positive
lesser-known	negative
lethal	negative
lethargic	negative
lewd	negative
liable	negative
liability	negative
liar	negative
liars	negative
liberal	positive
liberation	positive
licentious	negative
lie	negative
lies	negative
life-threatening	negative
lifeless	negative
lifelong	positive
light	positive
light-hearted	positive
likable	positive
likelihood	neutral
limit	negative
limited	negative
limitless	neutral
limp	negative
lionhearted	positive
listless	negative
literate	positive
litigious	negative
little	negative
little-known	negative
live	positive
lively	positive
loath	negative
loathe	negative
loathsome	negative
lofty	positive
logical	positive
lone	negative
lonely	negative
lonesome	negative
loopholes	negative
lorn	negative
losing	negative
lost	negative
lousy	negative
lovable	positive
loveless	negative
lovelorn	negative
lovely	positive
low	negative
low-cost	positive
low-rated	negative
low-risk	positive
lower-priced	positive
lowly	negative
loyal	positive
loyalty	positive
lucid	positive
lucidly	positive
luckier	positive
luckily	positive
lucky	positive
lucrative	positive
ludicrous	negative
lugubrious	negative
lukewarm	negative
luminous	positive
lunatic	negative
lurid	negative
lurking	negative
lush	positive
lustrous	positive
luxuriant	positive
luxury	positive
lyrical	positive
macabre	negative
mad	negative
madder	negative
magic	positive
magical	positive
magnetic	positive
magnificent	positive
majestic	positive
major	neutral
maladjusted	negative
malcontent	negative
malcontented	negative
malevolent	negative
malicious	negative
malign	negative
malignant	negative
malodorous	negative
maltreatment	negative
manageable	positive
maneuver	negative
maniacal	negative
manic	negative
manifest	positive
manipulation	negative
manipulative	negative
manipulators	negative
manly	positive
mannerly	positive
mantra	neutral
marginal	negative
martyrdom-seeking	negative
marvellous	positive
marvelous	positive
massive	neutral
master	positive
masterful	positive
masters	positive
matchless	positive
mature	positive
maverick	negative
maxi-devaluation	negative
meager	negative
mean	negative
meaningful	positive
meaningless	negative
mediocre	negative
meek	positive
melancholy	negative
mellow	positive
melodramatic	negative
memorable	positive
memories	neutral
mendacious	negative
menial	negative
merciless	negative
mercy	positive
mere	negative
meritorious	positive
merrily	positive
merry	positive
mess	negative
messy	negative
meticulous	positive
meticulously	positive
midget	negative
mild	positive
militancy	negative
mindful	positive
minor	neutral
miraculous	positive
mirage	negative
misbecoming	negative
misbegotten	negative
miscalculation	negative
mischief	negative
misconceptions	negative
miserable	negative
misguided	negative
misinformed	negative
misreading	negative
mistake	negative
mistakes	negative
mistrust	negative
misunderstanding	negative
misunderstandings	negative
mock	negative
mocking	negative
moderate	positive
moderation	positive
modern	positive
modest	positive
momentous	positive
monotonous	negative
monstrous	negative
monumental	positive
monumentally	positive
moody	negative
moot	negative
moral	positive
morbid	negative
morbidly	negative
mordant	negative
mordantly	negative
moribund	negative
mortified	negative
mortifying	negative
motionless	negative
motivated	positive
motivation	positive
motive	neutral
motley	negative
moving	positive
muddy	negative
mulish	negative
multi-polarization	negative
mum	neutral
mundane	negative
murderous	negative
murky	negative
mysterious	negative
mistified	negative
myth	negative
naive	negative
nap	neutral
narrow	negative
narrower	negative
nascent	neutral
nasty	negative
nationalism	negative
natural	positive
nature	neutral
naughty	negative
nauseating	negative
navigable	positive
neat	positive
nebulous	negative
necessarily	positive
necessary	positive
need	negative
needful	neutral
needless	negative
needs	neutral
needy	negative
nefarious	negative
negative	negative
neglected	negative
negligent	negative
negligible	negative
nettlesome	negative
nervous	negative
neurotic	negative
nice	positive
nifty	positive
nightmarish	negative
nimble	positive
noble	positive
noisy	negative
non-confidence	negative
non-violent	positive
nonexistent	negative
nonviolent	neutral
normal	positive
nosey	negative
notable	positive
noteworthy	positive
noticeable	positive
notion	neutral
notorious	negative
novel	positive
nourishing	positive
nuance	neutral
nuances	neutral
nuisance	negative
nurturing	positive
obedient	positive
obese	negative
objection	negative
objectionable	negative
objections	negative
objective	positive
obligation	neutral
oblique	negative
obliterated	negative
oblivious	negative
obnoxious	negative
obscene	negative
obscure	negative
obsessive	negative
obsolete	negative
obstacle	negative
obstinate	negative
obtrusive	negative
obtuse	negative
obvious	neutral
odd	negative
oddities	negative
offbeat	positive
offence	negative
offend	negative
offenses	negative
offensive	negative
officious	negative
okay	positive
olympic	neutral
ominous	negative
one-side	negative
onerous	negative
onslaught	negative
onward	positive
open	positive
openly	positive
open-ended	neutral
openness	positive
opinion	neutral
opinionated	negative
opinions	neutral
opportune	positive
opportunistic	negative
opposition	negative
oppositions	negative
oppression	negative
oppressive	negative
oppressors	negative
optimal	positive
optimistic	positive
opulent	positive
orderly	positive
original	positive
outburst	negative
outbursts	negative
outdated	negative
outgoing	positive
outlook	neutral
outmoded	negative
outraged	negative
outrageous	negative
outright	neutral
outspoken	neutral
outstanding	positive
ovation	positive
over-valuation	negative
overbalanced	negative
overbearing	negative
overblown	negative
overdue	negative
overjoyed	positive
oversimplified	negative
oversized	negative
overstatement	negative
overt	neutral
overtaxed	negative
overture	positive
overtures	neutral
overwhelming	negative
overworked	negative
overzealous	negative
pacifists	positive
pain	negative
painful	negative
painless	positive
pains	negative
painstaking	positive
palatable	positive
palatial	positive
pale	negative
paltry	negative
panicky	negative
paradoxical	negative
paralyzed	negative
paramount	positive
paranoid	negative
partiality	negative
particular	neutral
partisan	negative
partisans	negative
passe	negative
passionate	positive
passive	negative
passiveness	negative
pathetic	negative
patient	positive
patient	positive
patriotic	positive
paucity	negative
paupers	negative
payback	negative
peace	positive
peaceable	positive
peaceful	positive
peacekeepers	positive
pedantic	negative
pedestrian	negative
peerless	positive
peeved	negative
peevish	negative
penalty	negative
penetrating	positive
penitent	positive
perceptions	neutral
perceptive	positive
perfect	positive
perfidious	negative
perfunctory	negative
perilous	negative
peripheral	negative
permissible	positive
pernicious	negative
perplexed	negative
persecution	negative
persistence	neutral
persistent	positive
personages	positive
personality	positive
perspective	neutral
perspicuous	positive
persuasive	positive
pertinacious	negative
pertinent	positive
perturbed	negative
pervasive	
perverse	negative
pessimistic	negative
pestilent	negative
petrified	negative
petty	negative
phenomenal	positive
phobic	negative
phony	negative
picky	negative
picturesque	positive
pillar	positive
pious	positive
pithy	positive
pitiable	negative
pitiful	negative
pitifully	negative
pitiless	negative
pivotal	neutral
placid	positive
plague	negative
plain	positive
plausible	positive
player	neutral
playful	positive
plaything	negative
pleading	both
pleas	negative
pleasant	positive
pleasantly	positive
pleased	positive
pleasure	positive
plebeian	negative
pledges	positive
plenary	neutral
plentiful	positive
plotters	negative
ploy	negative
plush	positive
poetic	positive
poignant	positive
point	neutral
pointless	negative
poised	positive
poison	negative
poisonous	negative
poisonously	negative
polarisation	negative
polished	positive
polite	positive
polluter	negative
polluters	negative
pompous	negative
poor	negative
popular	positive
popularity	positive
portable	positive
posh	positive
position	neutral
positive	positive
possibility	neutral
posture	neutral
posturing	negative
potent	positive
potential	positive
power	neutral
powerful	positive
powerless	negative
practicable	positive
practical	positive
pragmatic	positive
praiseworthy	positive
praising	positive
pre-eminent	positive
preaching	positive
precarious	negative
precious	positive
precipitous	negative
precise	positive
predatory	negative
predictable	neutral
predominant	neutral
preeminent	positive
preemptive	positive
preferable	positive
preferences	positive
prejudice	negative
prejudicial	negative
premeditated	negative
premier	positive
premium	positive
prepared	positive
preponderance	positive
preposterous	negative
pressing	negative
pressure	neutral
pressures	neutral
prestigious	positive
presumptuous	negative
pretence	negative
pretense	negative
prevalent	neutral
priceless	positive
pricey	negative
prickles	negative
prideful	negative
primarily	neutral
primary	neutral
prime	neutral
primitive	negative
principle	positive
principled	positive
privileged	positive
pro-American	positive
pro-Beijing	positive
pro-Cuba	positive
pro-peace	positive
proactive	positive
problematic	negative
problems	negative
prodigious	positive
productive	positive
profane	negative
proficient	positive
profitable	positive
profound	positive
profuse	positive
progressive	positive
prohibitive	negative
prolific	positive
prominent	positive
promise	positive
promising	positive
promoter	positive
prompt	positive
propaganda	negative
proper	positive
propitious	positive
proportionate	neutral
proscription	negative
proscriptions	negative
prospect	positive
prospects	positive
prosperity	positive
prosperous	positive
protective	positive
protector	positive
protest	negative
protests	negative
protracted	negative
proud	positive
provocation	negative
provocative	negative
prudence	positive
prudent	positive
pugnacious	negative
punch	negative
punctual	positive
pundits	positive
punishable	negative
punitive	negative
puny	negative
puppet	negative
puppets	negative
pure	positive
purposeful	positive
quaint	positive
qualified	positive
qualify	positive
qualms	negative
quarrel	negative
quarrelsome	negative
quasi-ally	positive
queer	negative
questionable	negative
quick	neutral
quiet	neutral
racism	negative
racist	negative
radiant	positive
radical	negative
radicalization	negative
ragged	negative
raging	negative
rampant	negative
ramshackle	negative
rank	negative
ranting	negative
rapid	neutral
rapprochement	positive
raptureous	positive
rare	neutral
rash	negative
rational	positive
rationality	positive
raving	negative
re-conquest	positive
reaction	neutral
reactionary	negative
reactions	neutral
readiness	neutral
ready	positive
reaffirmation	positive
realistic	positive
realization	neutral
reasonable	positive
reassurance	positive
rebellious	negative
recalcitrant	negative
receptive	positive
recessionary	negative
reckless	negative
recognition	positive
recognizable	neutral
recommendations	positive
reconciliation	positive
record-setting	positive
recourses	negative
rectification	positive
rectifying	positive
redeeming	positive
redundant	negative
refined	positive
reflecting	neutral
reflective	neutral
refreshing	positive
refusal	negative
refutation	negative
regal	positive
regressive	negative
regret	negative
reiterated	neutral
reiterates	neutral
rejection	negative
relations	neutral
relaxed	positive
relevant	positive
reliable	positive
relief	positive
reluctance	negative
reluctant	negative
remark	neutral
remarkable	positive
reminiscent	positive
remorseful	negative
remorseless	negative
renewable	neutral
renowned	positive
repetitive	negative
replete	neutral
reprehensible	negative
reprehensive	negative
repression	negative
repressive	negative
reproach	negative
reproachful	negative
repudiation	negative
repugnant	negative
reputable	positive
reputed	neutral
resentful	negative
resentment	negative
reservations	negative
resigned	negative
resilient	positive
resistance	negative
resistant	negative
resolute	positive
resolve	positive
resolved	positive
resounding	positive
resourceful	positive
respect	positive
respectable	positive
resplendent	positive
responsible	positive
responsive	positive
restful	positive
restless	negative
restraint	positive
restricted	negative
restrictive	negative
resurgent	positive
retaliatory	negative
reticent	negative
revealing	neutral
revel	positive
revelation	positive
revengeful	negative
reverent	positive
reviled	negative
revolution	positive
revulsive	negative
rhetoric	negative
rhetorical	negative
rich	positive
rife	negative
rift	negative
rifts	negative
right	positive
righteous	positive
rightful	positive
rightness	positive
rights	positive
rigid	negative
rigorous	negative
ripe	positive
risk	negative
risk-free	positive
risky	negative
roadblocks	negative
robust	positive
rocky	negative
rogue	negative
rollercoaster	negative
rosy	positive
rotten	negative
rough	negative
rousing	positive
rude	negative
rue	negative
ruin	negative
ruinous	negative
rumbling	negative
rumor	negative
rumors	negative
rumours	negative
run-down	negative
rusty	negative
ruthless	negative
sacred	positive
sacrifice	negative
sad	negative
safe	positive
sage	positive
saintly	positive
salable	positive
salacious	negative
salutary	positive
sanctimonious	negative
sanctuary	positive
sanguine	positive
sane	positive
sanity	positive
sarcastic	negative
sardonic	negative
satirical	negative
satisfaction	positive
satisfactory	positive
satisfying	positive
savage	negative
savaged	negative
savvy	positive
scandal	negative
scandalized	negative
scant	negative
scarred	negative
scarce	negative
scared	negative
scarier	negative
scariest	negative
scars	negative
scary	negative
scathing	negative
scenic	positive
scholarly	neutral
screaming	neutral
scrupulous	positive
scrutiny	neutral
scummy	negative
seamless	positive
seasoned	positive
second-class	negative
second-tier	negative
secretive	negative
secure	positive
security	positive
sedentary	negative
seductive	positive
seedy	negative
seething	negative
selective	positive
self-coup	negative
self-criticism	negative
self-defeating	negative
self-destructive	negative
self-determination	positive
self-examination	neutral
self-humiliation	negative
self-interest	negative
self-satisfaction	positive
self-serving	negative
self-sufficiency	positive
self-sufficient	positive
senile	negative
sensation	positive
sensations	positive
sense	positive
senseless	negative
sensitive	positive
sensitivity	positive
sentiment	positive
serene	positive
settle	positive
set-up	negative
sever	negative
severe	negative
sexy	positive
shabby	negative
shadowy	negative
shady	negative
shaky	negative
shallow	negative
sham	negative
shambles	negative
shameful	negative
shameless	negative
sharp	negative
sheer	negative
shiny	positive
shock	negative
shocking	negative
shoddy	negative
short-lived	negative
showdown	negative
shrewd	positive
shrill	negative
shunned	negative
shy	negative
sick	negative
sickening	negative
sidetracked	negative
signals	neutral
significant	positive
simple	positive
simplified	positive
simplistic	negative
sin	negative
sinful	negative
sincere	positive
sincerity	positive
sinister	negative
sinking	negative
skeletons	negative
skeptical	negative
skepticism	negative
sketchy	negative
skilled	positive
skillful	positive
skimpy	negative
skittish	negative
skyrocketing	negative
slack	negative
slanderous	negative
slanders	negative
slashing	negative
slaughter	negative
slaughtered	negative
slaves	negative
sleazy	negative
sleek	positive
sleepy	neutral
slender	positive
slight	negative
slim	positive
sloppy	negative
slothful	negative
slow	negative
slow-moving	negative
sluggish	negative
slump	negative
sly	negative
smack	negative
smart	positive
smarter	positive
smiling	positive
smokescreen	negative
smoldering	negative
smooth	positive
smug	negative
smuttier	negative
smuttiest	negative
smutty	negative
sneaky	negative
so-cal	negative
sober	negative
sobering	negative
sociable	positive
soft-spoken	positive
soften	positive
solemn	negative
solid	positive
solidarity	positive
somber	negative
sophisticated	positive
sore	negative
sorry	negative
sound	positive
sour	negative
sourly	negative
sovereignty	neutral
spacious	positive
spade	negative
sparing	positive
sparkling	positive
specific	neutral
special	positive
spectacular	positive
speculation	neutral
speedy	positive
spilling	negative
spirit	positive
spirited	positive
spiritless	negative
spiritual	positive
spiteful	negative
splayed-finger	neutral
splendid	positive
splitting	negative
spookier	negative
spookiest	negative
spooky	negative
sporadic	negative
spot	negative
spotless	positive
spotty	negative
sprightly	positive
spurious	negative
squarely	positive
stability	positive
stable	positive
staggering	negative
stagnant	negative
staid	negative
stainless	positive
stake	negative
stale	negative
stampede	negative
stance	neutral
stances	neutral
stands	neutral
star	positive
stark	negative
stars	positive
stately	positive
statements	neutral
static	negative
statuesque	positive
staunch	positive
steadfast	positive
steady	positive
steep	negative
stellar	positive
stern	negative
sticky	negative
stiff	negative
stimulative	positive
sting	negative
stinging	negative
stingingly	negative
stir	neutral
stirring	positive
stodgy	negative
stolen	negative
stooges	negative
stormy	negative
straight	positive
straightforward	positive
strained	negative
strange	negative
streamlined	positive
strength	neutral
strenuous	negative
stressful	negative
stricken	negative
strict	negative
stride	positive
strident	negative
strides	positive
striking	positive
stringent	negative
striving	positive
strong	positive
stronger-than-expected	neutral
struggle	negative
stubborn	negative
studious	positive
stuffed	neutral
stuffy	negative
stunned	positive
stunning	positive
stunted	negative
stupendous	positive
stupified	negative
sturdy	positive
sty	negative
stylish	positive
suave	positive
subdued	negative
sublime	positive
submissive	negative
subordinate	negative
subservient	negative
substandard	negative
substantial	positive
substantive	positive
subtle	positive
subversive	negative
success	positive
successful	positive
sufferers	negative
suffering	negative
sufficient	positive
suggestions	positive
suicidal	negative
suitable	positive
sullen	negative
sumptuous	positive
sunny	positive
superficial	negative
superfluous	negative
superior	positive
superiority	negative
superlative	positive
support	positive
supporter	positive
supportive	positive
suppression	negative
supremacy	negative
supreme	positive
supurb	positive
surging	positive
surprise	neutral
surrender	negative
susceptible	negative
suspect	negative
suspicion	negative
suspicions	negative
suspicious	negative
sustainability	positive
sustainable	positive
sustained	positive
sweeping	positive
sweet	positive
swift	positive
swing	neutral
swipe	negative
sworn	positive
sympathetic	negative
sympathies	negative
sympathy	negative
syndrome	negative
systematic	neutral
taboo	negative
tale	neutral
talent	positive
talented	positive
tall	neutral
tangled	negative
tardy	negative
tawdry	negative
tedious	negative
temperate	positive
tenacious	positive
tendency	neutral
tender	positive
tense	negative
tension	negative
tentative	negative
tenuous	negative
tepid	negative
terrible	negative
terrific	positive
terrified	positive
terrifying	positive
terror-genic	negative
thinkable	positive
thinking	neutral
thorny	negative
thorough	positive
thought	neutral
thoughtful	positive
thoughtless	negative
threat	negative
threatening	negative
threats	negative
thrifty	positive
thriving	positive
thumbs	negative
tidy	positive
time-honored	positive
timely	positive
timid	negative
tiny	negative
tired	negative
tiresome	negative
tiring	negative
tolerable	positive
tolerance	positive
tolerant	positive
toll	negative
top	positive
tormented	negative
tortured	negative
tortuous	negative
torturous	negative
totalitarian	negative
traditional	positive
touches	neutral
touchy	negative
toughness	negative
toxic	negative
tragedy	negative
tragic	negative
traitorous	negative
traitorously	negative
tranquil	positive
tranquility	positive
transparency	neutral
transparent	neutral
trauma	negative
traumatic	negative
traumatized	negative
treacherous	negative
treasonous	negative
trendy	positive
trick	negative
tricky	negative
trim	positive
triumphal	positive
triumphant	positive
trivial	negative
trouble	negative
troublemaker	negative
troublesome	negative
truant	negative
truculent	positive
trust	positive
trustworthy	positive
truthful	positive
trying	negative
tumultuous	negative
turbulent	negative
twisted	negative
twists	negative
tyrannical	negative
ugliness	negative
ugly	negative
ulterior	negative
ultimatums	negative
ultra	positive
ultra-hardline	negative
unabashed	positive
unable	negative
unacceptable	negative
unaccustomed	negative
unanimous	positive
unassailable	positive
unattractive	negative
unaudited	neutral
unauthentic	negative
unavailable	negative
unavoidable	negative
unbiased	positive
unbearable	negative
unbound	positive
unbroken	positive
uncertain	negative
uncivil	negative
uncivilized	negative
unclean	negative
unclear	negative
uncollectible	negative
uncomfortable	negative
uncommon	positive
uncompetitive	negative
uncompromising	negative
unconcerned	positive
unconditional	positive
unconfirmed	negative
unconstitutional	negative
uncontrolled	negative
unconventional	positive
unconvincing	negative
uncouth	negative
undaunted	positive
undecided	negative
undefined	negative
undependable	negative
underdog	negative
underlings	negative
underpaid	negative
understandable	positive
understanding	positive
undesirable	negative
undetermined	negative
undignified	negative
undisputed	positive
undocumented	negative
undoubted	positive
undue	negative
unease	negative
uneasiness	negative
uneasy	negative
uneconomical	negative
unencumbered	positive
unethical	negative
uneven	negative
uneventful	negative
unexpected	negative
unexplained	negative
unfair	negative
unfaithful	negative
unfeeling	negative
unfettered	positive
unfinished	negative
unfit	negative
unforeseen	negative
unforgettable	positive
unfounded	negative
unfriendly	negative
unfulfilled	negative
unfunded	negative
ungrateful	negative
ungovernable	negative
unhappy	negative
unhealthy	negative
uniform	positive
unilateralism	negative
unimaginable	negative
unimportant	negative
uninformed	negative
uninsured	negative
unipolar	negative
unique	positive
unity	positive
universal	positive
unjust	negative
unjustifiable	negative
unjustified	negative
unkind	negative
unlawful	negative
unlawfulness	negative
unlicensed	negative
unlimited	positive
unlucky	negative
unmoved	negative
unnecessary	negative
unneeded	negative
unnerved	negative
unnoticed	negative
unobserved	negative
unorthodox	negative
unparalleled	positive
unpleasant	negative
unpleasantries	negative
unpopular	negative
unprecedent	negative
unpredictable	negative
unprepared	negative
unpretentious	positive
unproductive	negative
unprofitable	negative
unqualified	negative
unravel	negative
unraveled	negative
unrealistic	negative
unreasonable	negative
unrelenting	negative
unreliability	negative
unreliable	negative
unresolved	negative
unrestricted	positive
unruly	negative
unsafe	negative
unsatisfactory	negative
unsavory	negative
unscathed	positive
unscrupulous	negative
unselfish	positive
unsettled	negative
unskilled	negative
unsophisticated	negative
unsound	negative
unspeakable	negative
unspecified	negative
unstable	negative
unsteady	negative
unsuccessful	negative
unsupported	negative
unsure	negative
unsuspecting	negative
unsustainable	negative
untenable	negative
untested	negative
unthinkable	negative
untimely	negative
untouched	positive
untrained	positive
untrustworthy	negative
untruthful	negative
unwanted	negative
unwarranted	negative
unwieldy	negative
unwilling	negative
unwise	negative
unworkable	negative
unworthy	negative
unyielding	negative
upbeat	positive
upfront	positive
upliftment	positive
upright	positive
uproarous	negative
upscale	positive
upset	negative
upsetting	negative
upside	positive
upward	positive
urgency	negative
urgent	negative
usable	positive
useful	positive
useless	negative
utilitarian	positive
utmost	positive
utter	negative
utterances	neutral
uttermost	positive
vague	negative
vain	negative
vainly	negative
valiant	positive
valid	positive
valuable	positive
values	positive
vast	positive
venerable	positive
venom	negative
venomous	negative
vent	negative
verifiable	positive
veritable	positive
versatile	positive
vestiges	negative
veto	negative
viable	positive
vibrant	positive
vicious	negative
victorious	positive
victory	positive
view	neutral
viewpoints	neutral
views	neutral
vigilant	positive
vigorous	positive
vile	negative
villains	negative
villianous	negative
vintage	positive
violator	negative
violent	negative
virtuous	positive
virulent	negative
virus	negative
visionary	positive
vital	positive
vitality	positive
vivacious	positive
vivid	positive
vocal	neutral
vociferous	negative
volatile	negative
voluntary	positive
vulgar	negative
vulnerable	positive
waning	negative
wanton	negative
war	negative
war-like	negative
warlike	negative
warm	positive
warmhearted	positive
warning	negative
warped	negative
wary	negative
wasteful	negative
watchdog	negative
wayward	negative
weak	negative
weakening	negative
weakness	negative
weaknesses	negative
wealthy	positive
wearisome	negative
weary	negative
wedge	negative
wee	negative
weird	negative
welcome	positive
welfare	positive
well	positive
well-being	positive
well-connected	positive
well-educated	positive
well-established	positive
well-informed	positive
well-intentioned	positive
well-managed	positive
well-positioned	positive
well-publicized	positive
well-received	positive
well-regarded	positive
well-run	positive
well-wishers	positive
wellbeing	positive
whiff	neutral
whimsical	positive
whips	negative
white	positive
wholesome	positive
wicked	negative
wide	positive
wide-open	positive
wide-ranging	positive
widespread	negative
wild	negative
will	positive
willful	positive
willfully	positive
willing	positive
willingness	positive
wily	negative
wink	positive
winnable	positive
winners	positive
wisdom	positive
wise	positive
wish	positive
wishes	positive
wishing	positive
witty	positive
woebegone	negative
woeful	negative
wonderful	positive
wonderous	positive
workable	positive
world-famous	positive
worn	negative
worried	negative
worries	negative
worrisome	negative
worry	negative
worse	negative
worst	negative
worth	positive
worth-while	positive
worthiness	positive
worthless	negative
worthwhile	positive
worthy	positive
wound	negative
wounds	negative
wretched	negative
wrong	negative
wrongful	negative
wrought	negative
wry	positive
youthful	positive
zealous	negative
